11
8
21 21 21 21 21 21 21 21 21 21 21
21 0 0 0 0 0 0 0 0 0 21
21 0 0 0 0 0 0 0 0 0 21
21 0 0 0 0 0 0 0 21 21 21
21 0 0 0 0 0 0 0 0 0 21
21 0 0 0 0 0 21 21 0 0 21
21 0 0 0 0 0 0 0 0 0 21
21 21 21 21 21 21 21 21 21 21 21
