16
12
1 1 1 1 1 1 1 1 1 1 1 1 1 1 1 1
1 3 0 0 0 0 0 0 0 0 0 0 0 0 3 1
1 1 1 0 0 0 0 0 0 0 0 0 0 0 1 1
1 0 0 0 0 0 0 0 0 0 0 0 1 0 0 1
1 0 0 1 0 0 0 0 0 0 0 0 0 1 0 1
1 0 0 0 0 0 0 0 0 0 0 0 0 0 0 1
1 0 0 0 0 0 1 7 7 1 0 0 0 0 0 1
1 0 0 0 1 1 1 0 0 1 0 0 1 0 0 1
1 0 0 0 0 0 1 0 0 1 0 0 0 0 0 1
1 0 0 1 0 0 1 0 1 1 0 0 0 0 0 1
1 0 0 0 0 0 1 0 5 1 0 0 0 0 0 1
1 1 1 1 1 1 1 1 1 1 7 7 7 7 7 1