16
12
1 1 1 1 1 1 1 1 1 1 1 1 1 1 1 1
1 0 0 1 0 0 1 0 0 0 0 0 0 0 0 1
1 5 0 1 0 0 0 0 0 0 0 0 0 0 0 1
1 1 1 1 0 0 0 0 0 0 1 0 0 0 0 1
1 0 0 1 1 0 0 1 7 7 1 0 0 1 0 1
1 0 0 1 0 0 1 1 1 1 0 0 0 0 0 1
1 0 0 1 7 7 1 0 0 0 0 0 0 0 1 1
1 0 0 1 1 1 1 0 0 0 0 0 1 0 0 1
1 0 0 0 0 0 1 0 0 0 0 0 0 0 0 1
1 0 0 0 0 0 0 0 0 1 0 0 0 0 3 1
1 0 0 1 0 0 1 0 0 0 0 0 0 0 0 1
1 1 1 1 7 7 1 1 1 7 7 7 7 7 7 1